1 1 1 1 1 1 0 0 0 2 2 5 5 5 5 5 5 5 5 5 5 5 5 5 5 5 5 5 5 5 5 5 5 5 5 5 0 7 7 7 7 7 7 2 2 2 2 2 2 2 
1 0 0 0 0 1 0 0 0 2 2 5 5 5 5 5 5 5 5 5 5 5 5 5 5 5 5 5 5 5 5 5 5 5 0 0 0 0 7 7 7 8 7 2 2 2 2 2 2 2 
1 0 0 0 0 0 0 0 0 2 2 0 5 5 5 5 5 5 5 5 5 5 5 5 5 5 5 6 5 5 5 5 5 0 0 0 0 7 7 7 8 7 7 2 2 2 2 2 2 2   
1 0 0 0 0 1 0 0 0 2 2 0 0 5 5 5 5 5 5 5 5 5 5 5 5 5 5 5 5 5 5 5 0 0 0 0 7 7 7 7 7 8 2 2 2 2 2 2 2 2 
1 1 1 1 1 1 0 0 0 2 2 0 0 4 5 5 5 5 5 5 5 5 5 5 5 6 5 5 5 5 5 5 5 5 0 0 0 0 7 8 7 2 2 2 2 2 2 2 2 2  
4 0 0 0 0 0 0 0 0 2 2 0 5 0 5 5 5 5 5 5 5 5 5 5 5 5 5 5 5 5 5 5 5 5 0 0 0 0 7 7 7 7 7 2 2 2 2 2 2 2  
0 0 0 0 0 0 0 2 2 2 2 0 5 0 0 0 5 5 5 5 5 5 5 6 5 5 5 5 6 5 5 5 0 0 0 0 0 7 7 7 8 7 7 2 2 2 2 2 2 2 
6 5 4 0 0 0 2 2 2 2 2 0 5 0 4 0 5 5 5 5 5 5 5 5 5 5 5 5 5 5 0 0 0 0 0 0 7 7 7 7 7 7 7 2 2 2 2 2 2 2
0 5 5 0 0 2 2 2 2 2 2 0 0 0 0 0 5 5 5 5 5 5 5 5 5 5 5 5 5 5 5 5 5 0 0 0 0 7 7 7 7 7 7 2 2 2 2 2 2 2 
5 5 5 0 2 2 2 2 2 2 2 4 5 5 0 0 5 5 5 5 5 5 5 5 5 5 5 5 5 5 0 0 0 0 0 0 0 7 7 7 7 8 7 2 2 2 2 2 2 2 
3 3 3 3 3 3 3 3 3 2 2 0 4 5 0 0 5 5 5 5 5 5 5 5 5 5 5 5 5 5 5 5 0 0 0 7 7 7 7 7 7 7 7 2 2 2 2 2 2 2 
3 3 3 3 3 3 3 3 3 2 2 0 0 5 0 4 5 5 5 5 5 5 5 5 5 5 5 5 5 5 5 5 5 0 0 0 0 7 7 8 7 7 7 2 2 2 2 2 2 2 
3 3 3 3 3 3 3 3 3 2 2 0 5 5 5 5 5 5 5 5 5 5 5 5 5 5 5 5 5 6 5 5 5 5 5 5 0 7 7 7 7 7 7 7 2 2 2 2 2 2  
3 3 3 3 3 3 3 3 3 2 2 0 5 5 5 5 5 5 5 5 5 5 5 5 5 5 5 5 6 5 5 5 5 5 0 0 0 0 7 7 7 7 7 7 2 2 2 2 2 2 
3 3 3 3 3 3 3 3 3 2 2 0 5 5 5 5 5 5 5 5 5 5 5 5 5 5 5 5 5 5 5 5 5 0 0 0 0 7 7 7 7 7 7 2 2 2 2 2 2 2  
3 3 3 3 3 3 3 3 3 2 2 0 0 5 5 5 5 5 5 5 5 5 5 5 5 5 5 5 5 5 5 5 0 0 0 0 7 7 7 7 7 7 7 2 2 2 2 2 2 2 
3 3 3 3 3 3 3 3 3 2 2 0 0 4 5 5 5 5 5 5 5 5 5 5 5 5 5 5 5 5 5 5 5 5 0 0 0 0 7 7 7 7 8 2 2 2 2 2 2 2  
3 3 3 3 3 3 3 3 3 2 2 0 0 0 5 5 5 5 5 5 5 5 5 5 5 5 5 5 5 5 5 5 5 5 0 0 0 0 7 7 7 7 7 7 2 2 2 2 2 2  
0 0 0 0 0 0 0 2 2 2 2 0 0 0 0 0 5 5 5 5 5 5 5 5 5 5 5 5 5 5 5 5 0 0 0 0 0 7 7 7 7 7 7 7 2 2 2 2 2 2
6 5 4 0 0 0 2 2 0 2 2 0 0 0 4 0 5 5 5 5 5 5 5 5 5 5 5 5 5 5 0 0 0 0 0 0 7 7 7 7 7 7 7 7 2 2 2 2 2 2
0 5 5 0 0 2 2 0 0 2 2 0 0 0 0 0 5 5 5 5 5 5 5 5 5 5 5 5 5 5 5 5 5 0 0 0 0 7 7 7 7 7 7 2 2 2 2 2 2 2 
5 5 5 0 2 2 0 0 0 2 2 4 5 5 0 0 5 5 5 5 5 5 5 5 5 6 5 5 5 5 0 0 0 0 0 0 0 7 7 7 7 7 7 2 2 2 2 2 2 2 
5 5 6 5 2 2 0 0 0 2 2 0 4 5 0 0 5 5 5 5 5 5 5 5 5 5 5 5 5 5 5 5 0 0 0 7 7 7 7 7 7 7 7 7 2 2 2 2 2 2 
5 5 6 5 0 0 0 0 0 2 2 0 0 5 0 4 0 0 0 0 0 0 0 0 0 0 0 4 0 0 4 0 0 0 0 0 0 7 7 7 7 7 7 7 2 2 2 2 2 2
1 1 1 1 1 1 0 0 0 2 2 6 6 6 5 5 5 0 0 0 0 0 0 0 0 0 0 5 5 5 5 5 5 5 5 5 0 7 7 7 7 7 7 7 2 2 2 2 2 2 
1 0 0 0 0 1 0 0 0 2 2 5 6 6 6 6 0 0 0 0 0 0 0 0 0 0 6 5 5 5 5 5 5 5 0 0 0 0 7 7 7 7 7 2 2 2 2 2 2 2 
1 0 0 0 0 0 0 0 0 2 2 0 5 6 6 6 6 0 0 0 0 0 0 0 0 5 5 5 5 5 5 5 0 0 0 0 7 7 7 7 7 7 2 2 2 2 2 2 2 2 
1 0 0 0 0 1 0 0 0 2 2 0 0 6 6 6 5 5 0 0 0 0 0 5 5 6 5 5 5 5 5 5 0 0 0 0 7 7 7 7 7 7 7 2 2 2 2 2 2 2  
1 1 1 1 1 1 0 0 0 2 2 0 0 4 0 0 0 0 0 0 0 5 5 5 5 5 5 5 5 5 5 5 5 5 0 0 0 0 7 7 7 8 7 2 2 2 2 2 2 2   
4 0 0 0 0 0 0 0 0 2 2 5 5 0 5 5 5 0 0 0 0 5 5 5 5 5 5 5 5 5 5 5 5 5 0 0 0 0 7 7 7 7 7 7 2 2 2 2 2 2   
0 0 0 0 0 0 0 2 2 2 2 0 5 0 0 0 5 0 0 0 0 5 5 5 5 5 6 5 5 5 5 5 0 0 0 0 0 7 7 7 8 7 7 7 7 7 2 2 2 2 
6 5 4 0 0 0 2 2 0 2 2 0 5 0 4 0 5 0 0 0 0 6 6 5 5 5 5 5 6 5 0 0 0 0 0 0 7 7 7 7 7 7 7 7 7 7 7 7 7 2
0 5 5 0 0 2 2 0 0 2 2 5 0 0 0 0 5 5 5 4 0 6 6 5 5 5 5 5 5 5 5 5 5 0 0 0 0 7 7 7 7 7 7 7 7 7 2 2 2 2 
5 5 5 0 2 2 0 0 0 2 2 4 5 5 0 0 5 5 5 5 5 6 5 5 5 5 5 5 6 5 0 0 0 0 0 0 0 7 7 7 7 7 7 7 2 2 2 2 2 2  
3 3 3 3 3 3 3 3 3 2 2 0 4 5 0 0 5 5 5 5 5 6 5 5 5 5 5 5 5 5 5 5 0 0 0 7 7 7 7 7 7 8 7 2 2 2 2 2 2 2 
3 3 3 3 3 3 3 3 3 2 2 0 0 5 0 4 5 5 5 5 5 6 6 5 5 6 5 5 5 5 5 5 5 0 0 0 0 7 7 7 7 7 7 7 2 2 2 2 2 2 
3 3 3 3 3 3 3 3 3 2 2 0 5 5 5 5 5 5 5 5 5 5 6 5 5 5 5 6 5 5 5 5 5 5 5 5 0 7 7 7 7 7 7 7 2 2 2 2 2 2 
3 3 3 3 3 3 3 3 3 2 2 0 5 5 5 5 5 5 5 5 5 5 5 5 5 5 5 5 5 5 5 5 5 5 0 0 0 0 7 7 7 7 7 7 2 2 2 2 2 2
3 3 3 3 3 3 3 3 3 2 2 0 5 5 5 5 5 5 5 5 5 5 6 5 6 5 5 5 5 6 5 5 5 0 0 0 0 7 7 7 8 8 7 2 2 2 2 2 2 2  
3 3 3 3 3 3 3 3 3 2 2 0 0 5 5 5 5 5 5 5 5 5 5 5 5 5 5 5 5 5 5 5 0 0 0 0 7 7 7 8 8 7 7 2 2 2 2 2 2 2 
3 3 3 3 3 3 3 3 3 2 2 0 0 4 5 5 5 5 5 5 5 5 5 5 5 5 5 5 5 5 5 5 5 5 0 0 0 0 7 7 7 7 7 2 2 2 2 2 2 2  
3 3 3 3 3 3 3 3 3 2 2 0 5 0 5 5 5 5 5 5 5 5 5 5 6 6 5 5 5 5 5 5 5 5 0 0 0 0 7 7 8 7 7 7 2 2 2 2 2 2  
0 0 0 0 0 0 0 2 2 2 2 0 5 0 0 0 5 5 5 5 5 5 5 5 6 6 5 5 5 5 5 5 0 0 0 0 0 7 7 7 7 7 7 7 2 2 2 2 2 2 
6 5 4 0 0 0 2 2 0 2 2 0 5 0 4 0 5 5 5 5 5 5 5 5 5 5 5 5 5 5 0 0 0 0 0 0 7 7 7 7 7 7 7 7 2 2 2 2 2 2
0 5 5 0 0 2 2 0 0 2 2 5 0 0 0 0 5 5 5 5 5 5 5 5 5 5 5 5 5 5 5 5 5 0 0 0 0 7 7 7 7 7 7 7 2 2 2 2 2 2
5 5 5 0 2 2 0 0 0 2 2 4 5 5 0 0 5 5 5 5 5 5 5 5 5 5 5 5 5 5 0 0 0 0 0 0 0 7 7 7 7 7 7 7 2 2 2 2 2 2 
5 5 6 5 2 2 0 0 0 2 2 0 4 5 0 0 5 5 5 5 5 6 5 5 5 5 5 5 5 5 5 5 0 0 0 7 7 7 7 7 8 7 7 7 2 2 2 2 2 2
5 5 6 5 2 2 0 0 0 2 2 0 0 5 0 4 5 5 5 5 5 5 5 5 5 5 5 5 5 5 5 5 5 0 0 0 0 7 7 7 7 7 7 7 2 2 2 2 2 2
5 5 6 5 2 2 0 0 0 2 2 0 4 5 0 0 5 5 5 6 5 5 5 5 5 5 5 5 5 5 5 5 0 0 0 7 7 7 7 7 7 7 7 7 2 2 2 2 2 2 
5 5 6 5 2 2 0 0 0 2 2 0 0 5 0 4 5 5 5 5 5 5 5 5 5 5 5 5 5 5 5 5 5 0 0 0 0 7 8 7 7 7 7 7 2 2 2 2 2 2