1 1 1 1 1 1 0 0 0 2 2 5 5 5 5 5
1 0 0 0 0 1 0 0 0 2 2 5 5 5 5 5
1 0 0 0 0 0 0 0 0 2 2 0 5 5 5 5
1 0 0 0 0 1 0 0 0 2 2 0 0 5 5 5
1 1 1 1 1 1 0 0 0 2 2 0 0 4 5 5
4 0 0 0 0 0 0 0 0 2 2 5 5 0 5 5
0 0 0 0 0 0 0 2 2 2 2 0 5 0 0 0
6 5 4 0 0 0 2 2 0 2 2 0 5 0 4 0
0 5 5 0 0 2 2 0 0 2 2 5 0 0 0 0
5 5 5 0 2 2 0 0 0 2 2 4 5 5 0 0
5 5 6 5 2 2 0 0 0 2 2 0 4 5 0 0
5 5 6 5 2 2 0 0 0 2 2 0 0 5 0 4